border_size=1
usage=map

Mm          , Mm          , Ha          , Ha          , Mm          , Ha          , Ha          , Aa^Fpa      , Ha          , Ha          , Ha          , Gg          , Aa^Fpa      , Aa          , Aa^Fpa      , Aa          , Aa^Fpa      , Aa^Fpa      , Ha          , Aa^Fpa      , Ha          , Aa^Fpa      , Aa^Fpa      , Gg          , Ha          , Aa^Fpa      , Aa          , Aa^Fpa      , Aa^Fpa      , Gg          , Gg          , Gg          
Mm          , Mm          , Ha          , Ha          , Mm          , Ha          , Ha          , Aa^Fma      , Ha          , Ha          , Ha          , Gg          , Aa^Fma      , Aa          , Aa^Fpa      , Aa          , Aa^Fma      , Aa^Fma      , Ha          , Aa^Fpa      , Ha          , Aa^Fpa      , Aa^Fpa      , Gg          , Ha          , Aa^Fpa      , Aa          , Aa^Fpa      , Aa^Fpa      , Gg          , Gg          , Gg          
Mm          , Mm          , Mm          , Mm          , Mm          , Mm          , Ha          , Gg          , Ha          , Mm          , Gg          , Aa^Fpa      , Gg          , Aa^Fma      , Gg^Ve       , Aa^Fpa      , Aa          , Gg          , Aa^Fpa      , Ha          , Aa          , Aa^Fpa      , Aa          , Ha          , Ha          , Ha          , Aa^Fma      , Aa^Fma      , Ha          , Gg          , Gg          , Gg          
Ha          , Ha          , Aa^Fpa      , Ha          , Mm          , Mm          , Ha          , Mm          , Mm          , Mm          , Mm          , Ha          , Ha          , Gg          , Aa          , Aa^Fpa      , Aa^Fpa      , Ce          , 2 Ke        , Aa^Fpa      , Aa          , Aa^Fpa      , Aa^Fpa      , Aa^Fpa      , Aa          , Aa          , Aa^Fma      , Gg          , Ha          , Aa          , Aa^Fpa      , Aa^Fpa      
Aa          , Aa          , Aa^Fpa      , Ha          , Ha          , Aa^Fpa      , Aa^Fma      , Ha          , Ha          , Mm          , Ha          , Gg          , Aa^Fma      , Ha          , Gg          , Aa^Fma      , Aa^Fma      , Aa^Fpa      , Ce          , Ce          , Ce          , Aa          , Ha          , Gg          , Gg          , Aa^Fpa      , Aa          , Ha          , Aa^Fpa      , Ha          , Aa^Fma      , Aa^Fpa      
Gg          , Gg          , Aa^Fpa      , Gg          , Aa          , Ha          , Gg          , Ha          , Aa          , Aa^Fma      , Ha          , Ha          , Aa^Fma      , Aa^Fma      , Aa^Fpa      , Aa^Fda      , Aa          , Aa^Fpa      , Gg          , Ce          , Aa          , Aa          , Ha          , Aa^Fpa      , Gg^Ve       , Aa          , Aa^Fpa      , Ha          , Aa^Fpa      , Gs^Fp       , Aa          , Aa          
Aa^Fpa      , Aa^Fpa      , Ha          , Aa^Fpa      , Aa^Fda      , Aa          , Aa          , Aa          , Gg          , Aa          , Aa^Fda      , Ha          , Ha          , Gg          , Gg          , Aa          , Gg          , Gs^Fp       , Gg          , Aa          , Aa          , Aa^Fpa      , Aa^Fma      , Ha          , Aa          , Aa^Fpa      , Gg          , Gg          , Aa          , Gg          , Aa          , Aa          
Ha          , Ha          , Aa          , Gg          , Aa^Fda      , Aa^Fma      , Gg          , Aa^Fpa      , Gg          , Gg          , Gg^Ve       , Aa          , Aa^Fpa      , Aa^Fpa      , Gg          , Aa^Fpa      , Ha          , Gs^Fmw      , Gs^Fmw      , Gg          , Ha          , Aa^Fma      , Gs^Fdw      , Aa          , Ha          , Aa^Fpa      , Aa^Fpa      , Aa          , Aa^Fpa      , Gg          , Gg          , Gg          
Ha          , Ha          , Gg          , Gg          , Aa          , Aa^Fma      , Aa^Fpa      , Aa          , Ha          , Aa          , Aa^Fpa      , Aa          , Gg          , Aa^Fpa      , Aa^Fpa      , Ha          , Aa^Fpa      , Ha          , Gs^Fp       , Gg          , Ha          , Ha          , Aa^Fma      , Gg          , Gg          , Ha          , Aa^Fpa      , Gg          , Aa^Fma      , Gg          , Ww          , Ww          
Aa^Fpa      , Aa^Fma      , Aa^Fda      , Gs^Fdw      , Gs^Fdw      , Ha          , Ha          , Ha          , Aa          , Aa^Fpa      , Gg          , Aa^Fpa      , Aa^Fpa      , Aa          , Aa^Fpa      , Aa^Fpa      , Aa^Fpa      , Gg          , Aa^Fma      , Aa^Fpa      , Ha          , Gg          , Aa          , Aa^Fma      , Gg          , Gs^Fp       , Gg          , Aa          , Gs^Fp       , Ww          , Ww          , Ww          
Aa^Fpa      , Aa^Fpa      , Aa^Fma      , Gs^Fdw      , Gs^Fdw      , Gs^Fmw      , Gg          , Gg          , Aa          , Aa          , Aa^Fpa      , Aa^Fpa      , Aa          , Aa          , Ha          , Gg          , Gg^Ve       , Aa^Fma      , Gg          , Ha          , Gg          , Gg          , Aa          , Aa^Fma      , Aa^Fma      , Aa^Fma      , Gs^Fp       , Gg^Ve       , Gg          , Ww          , Ai          , Ai          
Aa          , Aa          , Aa^Fpa      , Gg          , Aa^Fda      , Aa^Fda      , Aa^Fpa      , Aa^Fma      , Aa^Fma      , Gg^Ve       , Gs^Fdw      , Aa^Fpa      , Aa^Fpa      , Ha          , Ha          , Gg          , Gs^Fdw      , Gs^Fdw      , Gg          , Gg          , Ai          , Gg          , Gg          , Aa          , Gg          , Gs^Fp       , Gg          , Gg          , Ww          , Ww          , Ai          , Ai          
Aa          , Aa          , Gg^Ve       , Aa^Fma      , Aa^Fma      , Gg          , Aa          , Ha          , Ha          , Aa^Fma      , Gs^Fdw      , Gs^Fdw      , Aa          , Ha          , Gs^Fp       , Aa          , Aa          , Gg          , Ww          , Ww          , Ww          , Ww          , Ww          , Gg          , Ai          , Gg          , Gg          , Gg          , Ww          , Ai          , Gg          , Gg          
Aa          , Aa          , Aa          , Gg          , Gs^Fmw      , Aa          , Aa^Fpa      , Ha          , Gg          , Aa^Fpa      , Aa^Fma      , Aa^Fma      , Aa          , Aa^Fpa      , Gg          , Gg          , Ww          , Ww          , Ai          , Ai          , Gg          , Gg          , Gg          , Ww          , Ww          , Ai          , Ww          , Ww          , Gg          , Gg          , Re^Gvs      , Re^Gvs      
Aa          , Aa          , Aa          , Aa^Fpa      , Aa          , Aa          , Gg          , Gg          , Gs^Fp       , Gg          , Gs^Fp       , Gs^Fmw      , Aa          , Gg          , Ai          , Ai          , Ww          , Ai          , Gg          , Gg          , Re^Gvs      , Re^Gvs      , Re^Gvs      , Gg          , Gg          , Ww          , Gg          , Gg^Vh       , Gg          , Re^Gvs      , Re^Gvs      , Re^Gvs      
Gg          , Gg          , Aa          , Gg          , Aa          , Aa^Fpa      , Gs^Fp       , Gg          , Gg          , Aa          , Aa          , Aa          , Gg          , Aa          , Ww          , Ww          , Gg          , Gg          , Re^Gvs      , Re^Gvs      , Re^Gvs      , Re^Gvs      , Gg          , Re^Gvs      , Re^Gvs      , Gg          , Gg          , Rr          , Gg          , Re^Gvs      , Gg          , Gg          
Gg          , Gg          , Ww          , Aa          , Ww          , Gg          , Ai          , Gg          , Ai          , Gg          , Ai          , Gg          , Ww          , Ww          , Gg          , Gg^Vh       , Rr          , Gg          , Gg          , Re^Gvs      , Gg          , Gg          , Rr          , Gg          , Gg          , Re^Gvs      , Gg          , Rr          , Gg          , Gg          , Rr          , Rr          
Ww          , Ww          , Gg          , Ww          , Ce          , Ww          , Ww          , Ai          , Ww          , Ai          , Ww          , Ww          , Gg          , Gg          , Re^Gvs      , Gg          , Gg          , Rr          , Rr          , Gg          , Rr          , Rr          , Gg          , Rr          , Rr          , Gg          , Rr          , Rr          , Rr          , Rr          , Gg          , Gg          
Gg          , Gg          , Ce          , Ce          , 1 Ke        , Ce          , Ce          , Ww          , Gg          , Ww          , Gg          , Gg          , Rr          , Gg          , Gg          , Re^Gvs      , Re^Gvs      , Gg          , Gg          , Rr          , Gg          , Gg          , Re^Gvs      , Gg          , Gg          , Rr          , Rr          , Rr          , Rr          , Gg          , Gg          , Gg          
Gg          , Gg          , Rr          , Rr          , Rr          , Rr          , Rr          , Rr          , Rr          , Rr          , Rr          , Rr          , Gg          , Rr          , Rr          , Gg          , Gg          , Re^Gvs      , Re^Gvs      , Gg          , Re^Gvs      , Re^Gvs      , Gg          , Gg          , Rr          , Rr          , Gg          , Gg          , Rr          , Rr          , Gg          , Gg          
Rr          , Rr          , Gg          , Gg          , Gg          , Gg          , Gg          , Gg          , Gg          , Gg^Vh       , Gg          , Gg          , Re^Gvs      , Gg          , Gg          , Rr          , Rr          , Gg          , Gg          , Re^Gvs      , Gg          , Gg          , Rr          , Rr          , Gg          , Gg          , Re^Gvs      , Gg          , Gg          , Gg          , Re^Gvs      , Re^Gvs      
Gg          , Gg          , Re^Gvs      , Re^Gvs      , Re^Gvs      , Re^Gvs      , Re^Gvs      , Re^Gvs      , Re^Gvs      , Gg          , Re^Gvs      , Re^Gvs      , Gg          , Gg          , Rr          , Rr          , Gg          , Rr          , Rr          , Gg          , Rr          , Rr          , Gg          , Gg          , Re^Gvs      , Re^Gvs      , Re^Gvs      , Re^Gvs      , Re^Gvs      , Re^Gvs      , Re^Gvs      , Re^Gvs      
Re^Gvs      , Re^Gvs      , Re^Gvs      , Re^Gvs      , Re^Gvs      , Re^Gvs      , Re^Gvs      , Re^Gvs      , Re^Gvs      , Re^Gvs      , Gg          , Gg          , Rr          , Rr          , Gg          , Gg          , Re^Gvs      , Gg          , Gg          , Rr          , Rr          , Gg          , Gg          , Re^Gvs      , Re^Gvs      , Re^Gvs      , Re^Gvs      , Re^Gvs      , Re^Gvs      , Re^Gvs      , Re^Gvs      , Re^Gvs      
Re^Gvs      , Re^Gvs      , Re^Gvs      , Re^Gvs      , Re^Gvs      , Re^Gvs      , Re^Gvs      , Re^Gvs      , Gg          , Gg          , Rr          , Rr          , Gg          , Gg          , Re^Gvs      , Re^Gvs      , Re^Gvs      , Gg          , Rr          , Rr          , Gg          , Rr          , Rr          , Gg          , Gg          , Re^Gvs      , Re^Gvs      , Re^Gvs      , Re^Gvs      , Re^Gvs      , Re^Gvs      , Re^Gvs      
Re^Gvs      , Re^Gvs      , Re^Gvs      , Re^Gvs      , Re^Gvs      , Re^Gvs      , Re^Gvs      , Gg          , Gg^Vh       , Rr          , Gg          , Gg          , Re^Gvs      , Re^Gvs      , Re^Gvs      , Re^Gvs      , Re^Gvs      , Gg          , Gg          , Gg^Vh       , Gg          , Gg          , Gg          , Rr          , Rr          , Gg          , Gg          , Re^Gvs      , Re^Gvs      , Re^Gvs      , Re^Gvs      , Re^Gvs      
Re^Gvs      , Re^Gvs      , Re^Gvs      , Re^Gvs      , Re^Gvs      , Re^Gvs      , Re^Gvs      , Gg          , Gg          , Gg          , Re^Gvs      , Re^Gvs      , Re^Gvs      , Re^Gvs      , Re^Gvs      , Re^Gvs      , Re^Gvs      , Re^Gvs      , Re^Gvs      , Gg          , Re^Gvs      , Re^Gvs      , Re^Gvs      , Gg          , Gg          , Rr          , Rr          , Gg          , Gg          , Re^Gvs      , Re^Gvs      , Re^Gvs      
Re^Gvs      , Re^Gvs      , Re^Gvs      , Re^Gvs      , Re^Gvs      , Re^Gvs      , Re^Gvs      , Gg          , Gg          , Gg          , Re^Gvs      , Re^Gvs      , Re^Gvs      , Re^Gvs      , Re^Gvs      , Re^Gvs      , Re^Gvs      , Re^Gvs      , Re^Gvs      , Re^Gvs      , Re^Gvs      , Re^Gvs      , Re^Gvs      , Re^Gvs      , Re^Gvs      , Gg          , Gg          , Rr          , Rr          , Gg          , Gg          , Re^Gvs      
