border_size=1
usage=map

Aa^Fpa      , Aa^Fdw      , Aa^Fma      , Ha          , Ha          , Gg          , Aa^Fpa      , Aa^Fpa      , Aa^Fdw      , Gg          , Ha          , Aa          , Aa          , Gg          , Ds          , Ai          , Ww          , Ww          , Ai          , Wo          , Wo          , Wo          , Wo          , Wo          , Wo          , Wo          , Wo          , Wo          , Wo          , Wo          , Wo          , Wo          , Wo          , Wo          , Wo          , Wo          , Wo          , Wo          , Wo          , Wo          , Wo          , Wo          , Wo          , Wo          , Wo          , Wo          
Aa^Fpa      , Aa^Fma      , Aa^Fdw      , Ha          , Ha          , Gg          , Aa^Fpa      , Aa^Fma      , Aa^Fdw      , Gs          , Ha          , Aa          , Aa          , Gg          , Ds          , Ai          , Ww          , Ww          , Ai          , Wo          , Wo          , Wo          , Wo          , Wo          , Wo          , Wo          , Wo          , Wo          , Wo          , Wo          , Wo          , Wo          , Wo          , Wo          , Wo          , Wo          , Wo          , Wo          , Wo          , Wo          , Wo          , Wo          , Wo          , Wo          , Wo          , Wo          
Gs^Fp       , Gs^Fmw      , Aa^Fdw      , Aa^Fma      , Gg          , Gs^Fp       , Aa^Fpa      , Aa^Fpa      , Aa^Fpa      , Ha          , Ha          , Ha          , Ds          , Gg          , Ds          , Ai          , Ww          , Wo          , Ai          , Ai          , Wo          , Wo          , Wo          , Wo          , Wo          , Wo          , Wo          , Wo          , Wo          , Wo          , Wo          , Wo          , Wo          , Wo          , Wo          , Wo          , Wo          , Wo          , Wo          , Wo          , Wo          , Wo          , Wo          , Wo          , Wo          , Wo          
Gs^Fp       , Gs^Fp       , Gs          , Gs          , Ha          , Aa^Fpa      , Aa^Fdw      , Aa^Fma      , Aa^Fdw      , Ha          , Ha          , Ha          , Ds          , Ds          , Ce          , Ai          , Ai          , Ww          , Wo          , Wo          , Wo          , Wo          , Wo          , Wo          , Wo          , Wo          , Wo          , Wo          , Wo          , Wo          , Wo          , Wo          , Wo          , Wo          , Wo          , Wo          , Wo          , Wo          , Wo          , Wo          , Wo          , Wo          , Wo          , Wo          , Wo          , Wo          
Aa^Fpa      , Aa^Fma      , Ha          , Ha          , Ha          , Gg          , Ha          , Ha          , Aa          , Gs^Fmw      , Aa^Fma      , Ds          , Ds          , Ce          , Rr          , Ce          , Ce          , Ww          , Ww          , Wo          , Wo          , Wo          , Wo          , Wo          , Wo          , Wo          , Wo          , Wo          , Wo          , Wo          , Wo          , Wo          , Wo          , Wo          , Wo          , Wo          , Wo          , Wo          , Wo          , Wo          , Wo          , Wo          , Wo          , Wo          , Wo          , Wo          
Gg          , Gg          , Gs^Fp       , Gs          , Aa^Fpa      , Gs          , Ha          , Ha          , Aa^Fpa      , Gs^Fdw      , Gs          , Ds          , Ds          , Ce          , Rr          , Rr          , Rr          , Ww          , Ww          , Ww          , Wo          , Wo          , Wo          , Wo          , Wo          , Wo          , Wo          , Wo          , Wo          , Wo          , Wo          , Wo          , Wo          , Wo          , Wo          , Wo          , Wo          , Wo          , Wo          , Wo          , Wo          , Wo          , Wo          , Wo          , Wo          , Wo          
Gs^Fp       , Gs^Fp       , Gg^Ve       , Aa^Fpa      , Aa^Fpa      , Ha          , Ha          , Aa^Fma      , Gs^Fmw      , Aa^Fpa      , Ha          , Ds          , Ds          , Ce          , Rr          , Rr          , Ce          , Rr          , Ww^Bw\      , Ww          , Wo          , Wo          , Wo          , Wo          , Wo          , Wo          , Wo          , Wo          , Wo          , Wo          , Wo          , Wo          , Wo          , Wo          , Wo          , Wo          , Wo          , Wo          , Wo          , Wo          , Wo          , Wo          , Wo          , Wo          , Wo          , Wo          
Gg          , Gg          , Aa^Fpa      , Aa^Fma      , Aa^Fma      , Aa^Fpa      , Gg          , Aa^Fpa      , Aa^Fpa      , Ha          , Ha          , Ds          , Ds          , Ce          , Ce          , Ce          , Ww          , Ww          , Ww          , Ww^Bw\      , Rr          , Wo          , Wo          , Wo          , Wo          , Wo          , Wo          , Wo          , Wo          , Wo          , Wo          , Wo          , Wo          , Wo          , Wo          , Wo          , Wo          , Wo          , Wo          , Wo          , Ww          , Wo          , Ww          , Wo          , Wo          , Wo          
Gg          , Gg          , Gs^Fp       , Chr         , Chr         , Aa^Fpa      , Gg^Ve       , Aa^Fma      , Gs^Fp       , Ha          , Gs^Fp       , Ha          , Gg          , Ds          , Ww          , Ww          , Ww          , Ww          , Ww          , Ww          , Ww^Bw|      , Wo          , Ww          , Wo          , Wo          , Wo          , Wo          , Wo          , Wo          , Wo          , Wo          , Wo          , Wo          , Wo          , Wo          , Wo          , Wo          , Wo          , Wo          , Ww          , Ww          , Ai          , Ai          , Ww          , Ww          , Ww          
Gs^Fp       , Gs^Fp       , Aa^Fpa      , Kh          , Chr         , Ha          , Aa^Fma      , Aa^Fdw      , Aa          , Gs^Fmw      , Gs^Fp       , Gs^Fp       , Aa          , Ds          , Ww          , Ww          , Wo          , Ww          , Ww          , Ww          , Ww^Bw|      , Ww          , Ch          , Ww          , Ww          , Wo          , Wo          , Wo          , Wo          , Wo          , Wo          , Wo          , Wo          , Wo          , Wo          , Wo          , Wo          , Wo          , Wo          , Ww          , Ds          , Ds          , Ai          , Ai          , Ww          , Ww          
Gs^Fp       , Gs^Fmw      , Gs^Fmw      , Chr         , Aa^Fma      , Chr         , Aa^Fma      , Aa^Fpa      , Ha          , Aa          , Aa          , Aa          , Ds          , Ds          , Ww          , Wo          , Wo          , Wo          , Ww          , Ww          , Rr          , Ch          , Rr          , Ch          , Ch          , Ww          , Ww          , Wo          , Wo          , Wo          , Wo          , Wo          , Wo          , Wo          , Ww          , Ww          , Ww          , Ww          , Ww          , Ww          , Ds          , Ds          , Ds          , Ds          , Ds          , Ds          
Gs^Fp       , Gs^Fmw      , Gs^Fp       , Gg^Ve       , Aa^Fdw      , Aa^Fma      , Gg          , Gs^Fp       , Aa          , Ha          , Gg          , Gs          , Ds          , Ww          , Ww          , Wo          , Wo          , Wo          , Ww          , Ch          , Rr          , Rr          , Rr          , Rr          , Rr          , Ch          , Ch          , Wo          , Wo          , Wo          , Wo          , Wo          , Wo          , Ww          , Ds          , Ds          , Ds          , Ww          , Ds          , Ds          , Gg          , Gg          , Aa^Fpa      , Gg          , Aa^Fpa      , Aa^Fpa      
Gg          , Gg          , Ha          , Gs^Fp       , Aa^Fpa      , Gg          , Gs          , Gs^Fmw      , Aa^Fma      , Aa^Fdw      , Hh          , Gs          , Gg          , Ds          , Ww          , Wo          , Wo          , Ww          , Ww          , Ch          , Rr          , Rr          , Ch          , Ch          , Ch          , Rr          , Rr          , Ch          , Ww^Bw\      , Wo          , Ww          , Wo          , Ww          , Ww          , Ds          , Ds          , Rr          , Ce          , Ce          , Ds          , Gg          , Aa^Fpa      , Gs^Fp       , Gs^Fp       , Aa^Fpa      , Aa^Fpa      
Gg          , Gs          , Ha          , Aa          , Aa^Fpa      , Aa^Fma      , Gg^Ve       , Gs          , Aa^Fma      , Hh          , Gs^Fdw      , Aa          , Aa          , Ds          , Wwf         , Ww          , Ww          , Wo          , Ww          , Ch          , Ch          , Rr          , Rr          , 2 Kh        , Ch          , Rr          , Rr          , Ch          , Wwf         , Ww^Bw\      , Ww^Bw\      , Wwf         , Wwf         , Wwf         , Ds          , Ds          , Ds          , Rr          , Rr          , Ce          , Gg          , Gs^Fp       , Hh          , Gg          , Gs^Fp       , Gs^Fp       
Gg          , Gg          , Gs^Fmw      , Aa          , Aa          , Aa^Fpa      , Gs^Fp       , Gg          , Aa^Fpa      , Hh          , Gs^Fmw      , Gg          , Aa          , Gg          , Wwf         , Wwf         , Ww          , Ww          , Wo          , Ww          , Ww          , Ch          , Rr          , Ch          , Rr          , Rr          , Ch          , Ch          , Wwf         , Wwf         , Wwf         , Ww^Bw\      , Ww^Bw\      , Wwf         , Wwf         , Ds          , Gg          , Gg^Vh       , Rr          , Ce          , Gg          , Gg          , Hh          , Gg          , Gs^Fp       , Gs^Fp       
Gg          , Gs          , Gs^Fp       , Hh          , Aa          , Gg          , Gs          , Gs          , Gg          , Aa^Fpa      , Gs          , Gs          , Gs          , Gg          , Gg          , Wwf         , Wwf         , Ww          , Ww          , Ww          , Ww          , Ch          , Ch          , Rr          , Ww^Bw|      , Ch          , Ww          , Ww          , Ww          , Ww          , Ww          , Ww          , Wo          , Ww^Bw\      , Gg          , Gg          , Gg          , Gg          , Rr          , Ce          , Gg          , Gs^Fp       , Gs^Fp       , Gg          , Gg          , Gg          
Gg          , Gg          , Aa^Fpa      , Gs          , Hh          , Gs^Fp       , Aa^Fpa      , Aa^Fma      , Gg          , Gs^Fmw      , Gg          , Gs^Fmw      , Gs^Fdw      , Gs^Fmw      , Gg          , Gg          , Gg          , Ww          , Ww          , Ww          , Wo          , Ww          , Ww          , Ch          , Ww^Bw|      , Ww          , Wo          , Wo          , Wo          , Wo          , Wo          , Wo          , Wo          , Wo          , Ww^Bw/      , Ds          , Ds          , Gg          , Rr          , Ce          , Gg          , Gg          , Gs^Fp       , Hh          , Hh          , Hh          
Gg          , Gs          , Gs^Fp       , Gs^Fp       , Gg^Ve       , Gs^Fp       , Gs          , Gg          , Aa^Fdw      , Gs^Fp       , Hh          , Gs          , Gg          , Gs^Fdw      , Gs          , Gg          , Gg          , Wwf         , Wwf         , Ww          , Wo          , Wo          , Ww          , Wo          , Ww^Bw|      , Wo          , Ww          , Wo          , Wo          , Wo          , Wo          , Wo          , Wo          , Ww          , Ww          , Wwf         , Ds          , Gg^Vh       , Rr          , Ce          , Gg          , Gg          , Gg          , Hh          , Hh          , Hh          
Gs^Fp       , Gs^Fp       , Gs          , Aa^Fma      , Gs^Fp       , Gs          , Aa^Fma      , Hh          , Hh          , Gg          , Hh          , Hh          , Gs^Fp       , Gs          , Gg          , Gg          , Gg          , Wwf         , Ww          , Wo          , Ww          , Ww          , Ww          , Ww          , Ww^Bw|      , Ww          , Ds          , Ww          , Ww          , Wo          , Wo          , Wo          , Ww          , Ww          , Ww^Bw\      , Ds          , Gg^Vh       , Gg          , Rr          , Ce          , Gg          , Gg          , Gs^Fp       , Hh          , Hh          , Hh          
Gg          , Gs          , Gs          , Gg          , Gs^Fmw      , Gs^Fp       , Gg          , Aa^Fma      , Gs^Fmw      , Hh          , Gs          , Gg          , Hh          , Gg          , Gg          , Gg          , Ww          , Ww          , Wo          , Wo          , Wwf         , Wwf         , Ds          , Ds          , Rr          , Ds          , Gg          , Ww^Bw/      , Ww          , Ww          , Ww          , Ww          , Ww^Bw|      , Ww          , Ds          , Ds          , Rr          , Rr          , Ce          , Rr          , Rr          , Gg          , Gg          , Gg          , Hh          , Hh          
Gs^Fp       , Gs^Fp       , Gg          , Gs^Fdw      , Gs^Fmw      , Gs          , Gs^Fp       , Aa^Fdw      , Gs^Fp       , Gs^Fp       , Hh          , Hh          , Gs          , Gg          , Gg          , Ww          , Ww          , Ww          , Wo          , Wwf         , Wwf         , Ce          , Gg          , Gg^Vh       , Rr          , Gg          , Gg          , Ds          , Ds          , Ww^Bw|      , Ds          , Ds          , Gg          , Ds          , Gg^Vh       , Rr          , Ce          , Ce          , Gg          , Gg          , Rr          , Gs^Fp       , Gs^Fp       , Gg          , Gs^Fp       , Gs^Fp       
Gs^Fp       , Gs^Fp       , Gs^Fp       , Gs^Fdw      , Gs          , Gs^Fp       , Gg          , Gs          , Gs          , Gs^Fp       , Gs          , Hh          , Gg          , Gg          , Gg          , Ww          , Ww          , Ww          , Ww          , Ww          , Gg          , Ce          , Ce          , Gg          , Rr          , Gg          , Gg^Vh       , Gg          , Gg          , Gg          , Gg          , Gg          , Gg^Vh       , Gg          , Rr          , Rr          , Ce          , Gg          , Gg          , Gg          , Rr          , Gg          , Gg          , Gs^Fp       , Gs^Fp       , Gs^Fp       
Gs          , Gg          , Gs          , Gs^Fp       , Gs^Fp       , Gs^Fp       , Gg          , Gs^Fmw      , Gg          , Gg          , Gg          , Gg          , Gg          , Gg          , Ww          , Ww          , Wo          , Ww          , Gg          , Gg          , Gg          , Gg          , Gg          , Ce          , Ce          , Rr          , Rr          , Gg          , Gg          , Gg          , Gg^Vh       , Gg          , Rr          , Rr          , Ce          , Ce          , Gg          , Gg          , Re^Gvs      , Gg          , Rr          , Gs^Fp       , Gs^Fp       , Gg          , Gs^Fp       , Gs^Fp       
Gg          , Gs          , Gg          , Gg^Ve       , Gs          , Gs^Fmw      , Gs^Fp       , Gs^Fdw      , Gg          , Gg          , Gg          , Gg          , Ww          , Ww          , Wo          , Wo          , Ww          , Ww          , Gg          , Gg          , Gg          , Gg          , Gg          , Gg          , Gg          , Ce          , Ce          , Rr          , Rr          , Rr          , Rr          , Rr          , Ce          , Ce          , Gg          , Gg          , Re^Gvs      , Re^Gvs      , Re^Gvs      , Gg          , Gg          , Rr          , Rr          , Gg          , Gg          , Gg          
Gg          , Gg          , Hh          , Hh          , Gg          , Gg          , Hh          , Gg          , Ww          , Gg          , Ww          , Ww          , Wo          , Wo          , Wo          , Ww          , Ww          , Gg          , Gg          , Gg          , Hh          , Hh          , Gg          , Gg          , Gg          , Gg          , Gg          , Rr          , Rr          , Ce          , Ce          , Ce          , Gg          , Gg          , Re^Gvs      , Re^Gvs      , Re^Gvs      , Re^Gvs      , Re^Gvs      , Re^Gvs      , Re^Gvs      , Gg          , Gg          , Rr          , Rr          , Rr          
Gg          , Gg          , Hh          , Hh          , Gg          , Gg          , Gg          , Ww          , Ww          , Ww          , Ww          , Ww          , Ww          , Ww          , Gg          , Ww          , Gg          , Gg          , Hh          , Hh          , Hh          , Hh          , Gg          , Gg          , Gg          , Gg          , Gg          , Rr          , Rr          , Gg          , Gg          , Gg          , Re^Gvs      , Re^Gvs      , Re^Gvs      , Re^Gvs      , Re^Gvs      , Re^Gvs      , Re^Gvs      , Re^Gvs      , Re^Gvs      , Re^Gvs      , Gg          , Gg          , Gg          , Gg          
Hh          , Hh          , Hh          , Hh          , Gg          , Gg          , Ww          , Ww          , Wo          , Wo          , Ww          , Ww          , Ww          , Ww          , Gg          , Gg          , Re^Gvs      , Hh          , Hh          , Hh          , Hh          , Hh          , Gg          , Gg          , Rr          , Gg          , Rr          , Rr          , Gg          , Gg          , Re^Gvs      , Re^Gvs      , Re^Gvs      , Re^Gvs      , Gg          , Re^Gvs      , Re^Gvs      , Re^Gvs      , Re^Gvs      , Re^Gvs      , Gg          , Gg          , Re^Gvs      , Re^Gvs      , Re^Gvs      , Re^Gvs      
Gg          , Gg          , Gg          , Hh          , Gg          , Ww          , Ww          , Wo          , Ww          , Ww          , Gg          , Gg          , Hh          , Gg          , Gg          , Re^Gvs      , Re^Gvs      , Re^Gvs      , Re^Gvs      , Hh          , Gg          , Gg          , Rr          , Rr          , Ch          , Rr          , Gg          , Gg          , Re^Gvs      , Re^Gvs      , Re^Gvs      , Re^Gvs      , Re^Gvs      , Gg          , Gg^Vh       , Ww          , Re^Gvs      , Re^Gvs      , Gg          , Gg          , Re^Gvs      , Re^Gvs      , Re^Gvs      , Re^Gvs      , Re^Gvs      , Re^Gvs      
Gg          , Gg          , Gg          , Gg          , Gg          , Ww          , Ww          , Wo          , Ww          , Ww          , Hh          , Hh          , Hh          , Gg          , Gg^Vh       , Gg          , Re^Gvs      , Re^Gvs      , Re^Gvs      , Re^Gvs      , Gg          , Rr          , Gg          , Ch          , Gg^Vh       , Ch          , Gg          , Re^Gvs      , Re^Gvs      , Re^Gvs      , Re^Gvs      , Re^Gvs      , Re^Gvs      , Gg          , Gg          , Gg          , Gg          , Gg          , Re^Gvs      , Re^Gvs      , Re^Gvs      , Re^Gvs      , Re^Gvs      , Re^Gvs      , Re^Gvs      , Re^Gvs      
Gg          , Gg          , Gg          , Gg          , Gg          , Ww          , Ww          , Ww          , Ww          , Gg          , Gg          , Gg          , Gg          , Gg          , Gg          , Ww          , Re^Gvs      , Re^Gvs      , Gg          , Gg          , Rr          , Rr          , Gg          , Ch          , Ch          , Kh          , Gg          , Re^Gvs      , Re^Gvs      , Re^Gvs      , Re^Gvs      , Re^Gvs      , Re^Gvs      , Re^Gvs      , Gg          , Gg          , Re^Gvs      , Re^Gvs      , Re^Gvs      , Re^Gvs      , Re^Gvs      , Re^Gvs      , Re^Gvs      , Re^Gvs      , Re^Gvs      , Re^Gvs      
Gg          , Gg          , Hh          , Hh          , Gg          , Ww          , Ww          , Wo          , Ww          , Gg          , Gg          , Re^Gvs      , Re^Gvs      , Re^Gvs      , Re^Gvs      , Re^Gvs      , Re^Gvs      , Re^Gvs      , Gg          , Rr          , Gg          , Gg          , Gg          , Gg          , Gg          , Gg          , Gg          , Re^Gvs      , Re^Gvs      , Re^Gvs      , Re^Gvs      , Re^Gvs      , Gg          , Gg          , Re^Gvs      , Re^Gvs      , Re^Gvs      , Re^Gvs      , Re^Gvs      , Re^Gvs      , Re^Gvs      , Re^Gvs      , Re^Gvs      , Re^Gvs      , Re^Gvs      , Re^Gvs      
Gg          , Gg          , Hh          , Hh          , Gg          , Ww          , Ww          , Wo          , Wo          , Ww          , Gg          , Re^Gvs      , Hh          , Hh          , Re^Gvs      , Re^Gvs      , Gg          , Gg          , Gg          , Rr          , Gg          , Re^Gvs      , Re^Gvs      , Re^Gvs      , Re^Gvs      , Gg          , Re^Gvs      , Gg          , Gg          , Re^Gvs      , Gg          , Gg          , Re^Gvs      , Re^Gvs      , Re^Gvs      , Re^Gvs      , Re^Gvs      , Re^Gvs      , Gg          , Re^Gvs      , Re^Gvs      , Re^Gvs      , Re^Gvs      , Re^Gvs      , Re^Gvs      , Re^Gvs      
Gg          , Gg          , Hh          , Hh          , Gg          , Gg          , Ww          , Wo          , Ww          , Ww          , Gg          , Re^Gvs      , Hh          , Hh          , Re^Gvs      , Gg          , Kh          , Ch          , Ch          , Rr          , Gg          , Re^Gvs      , Re^Gvs      , Re^Gvs      , Re^Gvs      , Re^Gvs      , Re^Gvs      , Re^Gvs      , Re^Gvs      , Gg          , Gg          , Re^Gvs      , Re^Gvs      , Re^Gvs      , Re^Gvs      , Re^Gvs      , Re^Gvs      , Gg          , Gg^Vh       , Gg          , Re^Gvs      , Re^Gvs      , Re^Gvs      , Re^Gvs      , Re^Gvs      , Re^Gvs      
Gg          , Gg          , Gg          , Gg^Ve       , Gg          , Gg          , Ww          , Ww          , Ww          , Ww          , Gg          , Gg          , Gg          , Re^Gvs      , Gg          , Gg          , Ch          , Gg^Vh       , Ch          , Rr          , Gg          , Re^Gvs      , Re^Gvs      , Re^Gvs      , Re^Gvs      , Re^Gvs      , Re^Gvs      , Re^Gvs      , Re^Gvs      , Re^Gvs      , Re^Gvs      , Gg          , Gg          , Re^Gvs      , Re^Gvs      , Re^Gvs      , Re^Gvs      , Gg          , Gg          , Ww          , Re^Gvs      , Re^Gvs      , Re^Gvs      , Re^Gvs      , Re^Gvs      , Re^Gvs      
Gg          , Gg          , Gg          , Gg          , Gg          , Gg          , Ww          , Ww          , Ww          , Gg          , Gg          , Gg          , Gg          , Gg          , Rr          , Gg          , Rr          , Ch          , Rr          , Rr          , Gg          , Re^Gvs      , Re^Gvs      , Re^Gvs      , Re^Gvs      , Re^Gvs      , Re^Gvs      , Re^Gvs      , Re^Gvs      , Re^Gvs      , Re^Gvs      , Re^Gvs      , Re^Gvs      , Gg          , Gg          , Re^Gvs      , Re^Gvs      , Re^Gvs      , Re^Gvs      , Re^Gvs      , Re^Gvs      , Re^Gvs      , Re^Gvs      , Re^Gvs      , Re^Gvs      , Re^Gvs      
Gg          , Gg          , Ww          , Ww          , Ww          , Ww          , Wo          , Wo          , Ww          , Gg          , Gg          , Gg          , Rr          , Rr          , Gg          , Rr          , Gg          , Rr          , Gg          , Gg          , Re^Gvs      , Re^Gvs      , Re^Gvs      , Re^Gvs      , Re^Gvs      , Re^Gvs      , Gg          , Re^Gvs      , Re^Gvs      , Re^Gvs      , Re^Gvs      , Re^Gvs      , Re^Gvs      , Re^Gvs      , Re^Gvs      , Gg          , Gg          , Re^Gvs      , Re^Gvs      , Re^Gvs      , Re^Gvs      , Re^Gvs      , Re^Gvs      , Re^Gvs      , Re^Gvs      , Re^Gvs      
Ww          , Ww          , Wo          , Ww          , Ww          , Wo          , Ww          , Ww          , Gg          , Gg          , 1 Gg        , Gg          , Rr          , Gg          , Gg          , Gg          , Re^Gvs      , Gg          , Re^Gvs      , Re^Gvs      , Re^Gvs      , Re^Gvs      , Re^Gvs      , Re^Gvs      , Re^Gvs      , Gg          , Gg^Vh       , Ww          , Re^Gvs      , Re^Gvs      , Re^Gvs      , Re^Gvs      , Re^Gvs      , Re^Gvs      , Re^Gvs      , Re^Gvs      , Re^Gvs      , Gg          , Gg          , Re^Gvs      , Re^Gvs      , Re^Gvs      , Re^Gvs      , Re^Gvs      , Re^Gvs      , Re^Gvs      
Wo          , Wo          , Ww          , Ww          , Ww          , Ww          , Gg          , Gg          , Gg          , Gg          , Gg          , Rr          , Gg          , Gg          , Re^Gvs      , Re^Gvs      , Re^Gvs      , Re^Gvs      , Re^Gvs      , Re^Gvs      , Re^Gvs      , Re^Gvs      , Re^Gvs      , Re^Gvs      , Re^Gvs      , Gg          , Gg          , Gg          , Re^Gvs      , Re^Gvs      , Re^Gvs      , Re^Gvs      , Re^Gvs      , Re^Gvs      , Re^Gvs      , Re^Gvs      , Re^Gvs      , Re^Gvs      , Re^Gvs      , Gg          , Gg          , Re^Gvs      , Re^Gvs      , Re^Gvs      , Re^Gvs      , Re^Gvs      
Ww          , Ww          , Ww          , Gg          , Gg          , Gg          , Gg          , Gg          , Gg          , Gg          , Rr          , Rr          , Gg          , Re^Gvs      , Gg          , Gg          , Re^Gvs      , Re^Gvs      , Re^Gvs      , Re^Gvs      , Re^Gvs      , Re^Gvs      , Re^Gvs      , Re^Gvs      , Re^Gvs      , Re^Gvs      , Re^Gvs      , Re^Gvs      , Re^Gvs      , Re^Gvs      , Re^Gvs      , Re^Gvs      , Re^Gvs      , Re^Gvs      , Re^Gvs      , Re^Gvs      , Re^Gvs      , Re^Gvs      , Re^Gvs      , Re^Gvs      , Re^Gvs      , Gg          , Gg          , Re^Gvs      , Re^Gvs      , Re^Gvs      
Ww          , Ww          , Ww          , Gg          , Gg          , Gg          , Gg          , Gg          , Rr          , Rr          , Gg          , Gg          , Gg          , Re^Gvs      , Gg          , Gg          , Re^Gvs      , Re^Gvs      , Re^Gvs      , Re^Gvs      , Re^Gvs      , Re^Gvs      , Re^Gvs      , Re^Gvs      , Re^Gvs      , Re^Gvs      , Re^Gvs      , Re^Gvs      , Re^Gvs      , Re^Gvs      , Re^Gvs      , Re^Gvs      , Re^Gvs      , Re^Gvs      , Re^Gvs      , Re^Gvs      , Re^Gvs      , Re^Gvs      , Re^Gvs      , Re^Gvs      , Re^Gvs      , Gg          , Gg          , Re^Gvs      , Re^Gvs      , Re^Gvs      
